11111111111
1C000C00011
1EC0P000C11
1C000C00011
11111111111
