11111111111111111111111111111111
100000000CC000000000CCCCC0000001
10000000C11C0000000C11111C000001
1000000C11C0000000C11CCC11C00001
100000C11CC000000C11C000C11C0001
10000C11CC1C00000C11C000C11C0001
1000C11CC11C0000C11C0000C11C0001
100C11CCC11CC0000CC00000C11C0001
100C111111111C000000000C11C00001
1000CCCCC11CC00000000CC111C00001
10000000C11C00000000C111CC000001
10000000C11C000000C111CCCCCC0001
10000000C11C00000C1111111111C001
100000000CC0000000CCCCCCCCCC00C1
1P000000000000000000000000000CE1
11111111111111111111111111111111
