1111111111111
1E000000000C1
1110000000001
1P00000000001
1111111111111
