1111111111111
1E00000000001
1P00000000001
1C00000000001
1111111111111
