111111111
1C0C0EP11
111111111
